####################
#.......#.D..#.....#
#.##..D.###..#.#...#
#.####..#..#.#.###.#
#...###....#.#.#...#
###..S.........#.D.#
#D#....###D.....####
#.#...#####..#.....#
#.....#####....###.#
#.#......#...#.#D..#
#..#.....#S#.#.###.#
#...#..D....##.....#
#...##.......##....#
#...#.#.......#.D..#
#...#..#.####......#
#..B......D.#......#
#............S#....#
###############....#
#D................D#
####################